of	de
to	a
and	y
a	un/una
in	en
is	es
it	eso
you	tú
that	ese
he	él
was	estaba
for	para
on	en
are	son
with	con
as	como
I	yo
his	su
they	ell@s
be	ser
at	a
one	uno
have	tener
this	est@
from	de
or	o
had	tenido
by	por
hot	caliente
word	palabra
but	pero
what	qué
some	algunos
we	nosotros
can	poder
out	fuera
other	otro
were	fueron
all	todas
there	ahí
when	cuando
up	arriba
use	utilizar
your	su
how	cómo
said	dijo
an	un
each	cada
she	ella
which	cual
do	hacer
their	su
time	tiempo
if	si
will	será
way	camino
about	acerca de
many	muchos
then	entonces
them	ellos
write	escribir
would	haría
like	me gusta
so	asi que
these	estas
her	su
long	largo
make	hacer
thing	cosa
see	ver
him	él
two	dos
has	tiene
look	Mira
more	Más
day	día
could	podría
go	ir
come	ven
did	hizo
number	número
sound	sonar
no	no
most	más
people	gente
my	mi
over	encima
know	saber
water	agua
than	que
call	llamada
first	primero
who	quien
may	mayo
down	abajo
side	lado
been	estado
now	ahora
find	encontrar